EA ./textures/dong.xpm
WE ./textures/seo.xpm
SO ./textures/nam.xpm
NO ./textures/book.xpm

F 220,100,0
C 225,30,0


11111 1111111
1000111000111
11000000011          1
 100010001          101
1100000011           1
1111111101   
1111 11111  
             
            
111111111111111111111111111111111111111111111111111111111111111111111111111111111111111111111111111111111111111111111111111111111111111111111111111111
100000000000000000000000000000000000000000000000000000000000000000000000000000000000000000000000000000000000000000000000000000000000000000000000000001
111111111111111111111111111111111111111111111111111111111111111111111111111111111111111111111111111111111111111111111111111111111111111111111111111111