EA ./textures/E.xpm
WE ./textures/W.xpm
SO ./textures/S.xpm
NO ./textures/N.xpm

F 220,100,0
C 225,30,0


11111 1111111
1000111000111
11000000011          1
 100010001          101
1100000011           1
1111111101   
1111 11111  
             
            
111111111111111111111111111111111111111111111111111111111
1E000000001
111111111111111111111111111111111111111111111111111111111111111